01 01 01 01 01 01 01 01 01 01 01 01 01 01 01 01 01 01 01 01 01 01 01 01 01 01 01 01 01 01 01 01 01 01 01 01 01 01 01 01 01 01 01 01 01 01 01 01 01 01
01 01 01 01 01 01 11 12 12 12 02 02 02 02 01 01 01 01 01 01 01 01 01 02 02 02 02 02 02 02 02 02 02 02 02 01 01 01 01 01 01 01 01 01 01 01 01 01 01 01
01 01 01 01 11 12 22 02 02 02 02 02 02 02 02 02 02 01 01 01 02 02 02 02 02 02 02 02 02 02 03 03 02 02 02 02 02 01 01 01 01 01 01 01 01 01 01 01 01 01
01 01 01 02 02 02 02 02 02 02 02 02 02 02 02 02 02 02 02 02 02 02 02 02 02 02 02 02 02 03 03 03 03 03 03 03 02 01 01 01 01 01 01 01 01 01 01 01 01 01
01 01 02 02 02 02 02 02 02 02 02 03 03 03 03 03 03 03 03 02 02 02 02 02 01 01 01 01 02 03 03 03 03 03 03 03 02 02 01 01 01 01 01 01 01 01 01 01 01 01
01 01 02 02 02 02 02 02 02 02 02 03 03 03 03 03 03 03 03 03 03 02 02 02 01 01 01 01 02 02 03 03 03 03 03 03 03 02 01 01 01 01 01 01 01 01 01 01 01 01
01 02 02 02 02 02 02 02 02 03 03 03 03 03 03 03 03 03 03 03 02 02 02 01 01 01 01 01 01 02 02 02 03 03 03 03 03 02 01 01 01 01 01 01 01 01 01 01 01 01
01 02 02 02 02 02 02 03 03 03 03 03 03 03 03 03 03 03 03 02 02 02 02 01 01 01 01 01 01 01 03 02 03 03 03 03 03 02 01 01 01 01 01 02 01 01 01 01 01 01
01 02 02 02 02 02 02 03 02 02 03 03 03 03 03 03 03 03 02 02 02 02 01 01 01 01 01 01 01 01 01 02 02 03 03 03 03 02 01 01 01 01 02 02 02 02 02 01 01 01
01 02 02 02 02 02 03 03 02 02 03 03 03 03 03 03 03 03 02 02 02 01 01 01 01 01 01 01 01 01 01 01 02 03 03 03 03 02 01 01 01 02 02 02 02 02 02 02 01 01
01 02 02 02 02 03 03 03 02 02 03 03 03 03 03 03 03 02 02 01 01 01 01 01 01 01 01 01 01 01 01 01 02 03 03 03 03 02 01 01 02 02 03 02 02 02 02 02 01 01
01 02 02 02 02 03 03 03 02 02 03 03 03 03 03 03 03 02 02 02 01 01 01 01 01 01 01 01 01 01 01 01 02 03 03 03 03 02 01 01 02 03 03 02 02 02 02 02 02 01
01 02 02 02 02 03 03 03 02 02 03 03 03 03 03 03 03 03 02 02 02 01 01 01 01 01 01 01 01 01 01 01 02 03 03 03 02 02 01 01 02 03 03 03 02 02 02 02 02 01
01 01 02 02 02 03 03 03 02 02 03 03 03 03 03 03 03 03 03 02 02 02 01 01 01 01 01 01 01 01 01 02 02 03 03 03 02 01 01 01 02 03 03 03 03 02 02 02 02 01
01 01 01 02 02 03 03 03 02 02 03 03 03 03 03 03 03 03 03 03 02 02 02 02 01 01 01 01 01 02 02 02 03 03 03 03 02 01 01 02 03 03 03 03 03 02 02 02 02 01
01 01 01 02 02 03 03 03 02 02 03 03 03 03 03 03 03 03 03 03 03 03 02 02 02 02 01 01 02 02 03 03 03 03 03 03 02 01 01 02 03 03 03 03 03 02 02 02 02 01
01 01 01 01 02 03 03 03 02 02 03 03 03 03 03 03 03 03 03 03 03 03 02 02 02 02 02 02 02 03 03 03 03 03 03 03 02 01 01 02 03 03 03 03 03 02 02 02 02 01
01 01 01 01 02 03 03 03 02 02 03 03 03 03 03 03 03 03 03 03 03 03 03 02 02 03 03 03 03 03 03 03 03 03 03 03 02 01 01 02 03 03 03 03 03 02 02 02 02 01
01 01 01 01 02 02 03 03 02 02 03 03 03 03 03 03 03 03 03 03 03 03 03 02 02 03 03 03 03 03 03 03 03 03 03 03 02 01 02 02 03 03 03 03 03 03 02 02 02 01
01 01 01 01 01 02 03 03 02 02 03 03 03 03 03 03 03 03 03 03 03 03 03 02 02 03 03 03 03 03 03 03 03 03 03 03 02 01 02 02 03 03 03 03 03 03 02 02 02 01
01 01 01 01 01 02 03 03 02 02 03 03 03 03 03 03 03 03 03 03 03 03 03 02 02 03 03 03 03 03 03 03 03 03 03 03 02 01 02 02 03 03 03 03 03 03 02 02 01 01
01 01 01 01 01 02 03 03 02 02 03 03 03 03 03 03 03 03 03 03 03 03 03 02 02 03 03 03 03 03 03 03 03 03 03 02 02 01 02 03 03 03 03 03 03 03 02 02 01 01
01 01 01 01 01 02 03 03 02 02 03 03 03 03 03 03 03 03 03 03 03 03 03 02 02 03 03 03 03 03 03 03 03 03 03 02 01 02 02 03 03 03 03 03 03 03 02 01 01 01
01 01 01 01 01 02 03 03 02 02 02 02 02 02 02 02 02 02 02 02 02 02 02 02 02 02 02 02 02 02 02 02 02 02 02 02 01 02 02 02 02 02 02 02 02 02 02 01 01 01
01 01 01 01 01 02 03 03 02 02 02 02 02 02 02 02 02 02 02 02 02 02 02 02 02 02 02 02 02 02 02 02 02 02 02 02 01 02 02 02 02 02 02 02 02 02 02 01 01 01
01 01 01 01 01 02 03 03 03 03 03 03 03 02 02 03 03 03 03 03 03 03 03 03 03 03 03 03 03 03 03 03 03 03 02 01 01 02 03 03 03 03 03 03 02 02 02 01 01 01
01 01 01 01 01 02 03 03 03 03 03 03 03 02 02 03 03 03 03 03 03 03 03 03 03 03 03 03 03 03 03 03 03 03 02 01 02 02 03 03 03 03 03 03 02 02 02 01 01 01
01 01 01 01 01 02 03 03 03 03 03 03 03 02 02 03 03 03 03 03 03 03 03 03 03 03 03 03 03 03 03 03 03 02 02 01 02 02 03 03 03 03 03 03 02 02 02 01 01 01
01 01 01 01 02 02 03 03 03 03 03 03 03 02 02 03 03 03 03 03 03 03 03 03 03 03 03 03 03 03 03 03 02 02 01 01 02 02 03 03 03 03 03 03 02 02 02 02 01 01
01 01 01 01 02 03 03 03 03 03 03 03 03 02 02 03 03 03 03 03 03 03 03 03 03 03 03 03 03 03 03 02 02 01 01 01 01 02 03 03 03 03 03 03 02 02 03 02 01 01
01 01 01 01 02 03 03 03 03 03 03 03 03 02 02 03 03 03 03 03 03 03 03 03 03 02 02 02 02 02 02 02 01 01 01 01 01 02 03 03 03 03 03 03 02 02 03 02 01 01
01 01 01 02 02 03 03 03 03 03 03 03 03 02 02 03 03 03 03 03 03 03 03 02 02 02 02 01 01 01 01 01 01 01 01 01 01 02 02 03 03 03 03 03 02 02 03 02 02 01
01 01 02 02 03 03 03 03 03 03 03 03 03 02 02 03 03 03 03 03 03 03 02 02 02 02 01 01 01 01 01 01 01 01 01 01 01 01 02 02 03 03 03 03 02 02 03 03 02 01
01 01 02 03 03 03 03 03 03 03 03 03 03 02 02 03 03 03 03 03 03 02 02 02 02 01 01 01 01 01 01 01 01 01 01 01 01 01 01 02 02 03 03 03 02 02 03 03 02 01
01 01 02 03 03 03 03 03 03 03 03 03 03 02 02 03 03 03 03 03 03 02 02 02 02 01 01 01 01 01 01 01 01 01 01 01 01 01 01 01 02 03 03 03 02 02 03 03 02 01
01 02 02 03 03 03 03 03 03 03 03 03 03 02 02 03 03 03 03 03 02 02 02 02 01 01 01 01 01 01 01 01 01 01 01 01 01 01 01 01 02 02 03 03 02 02 03 03 02 01
01 02 03 03 03 03 03 03 03 03 03 03 03 02 02 02 02 02 02 02 02 02 02 02 01 01 01 01 01 01 01 01 01 01 01 01 01 01 01 01 01 02 03 03 02 02 03 03 02 01
01 02 03 03 03 03 03 03 03 03 03 03 03 02 02 02 02 02 02 02 02 02 02 02 01 01 01 01 01 01 01 01 01 01 01 01 01 01 01 01 01 02 03 03 02 02 03 03 02 01
01 02 03 03 03 03 03 03 03 03 03 03 03 02 02 03 03 03 03 03 02 02 02 02 01 01 01 01 01 01 01 01 01 01 01 01 01 01 01 01 01 02 03 03 02 02 03 03 02 01
01 02 03 03 03 03 03 03 03 03 03 03 03 02 02 03 03 03 03 03 02 02 02 02 01 01 01 01 01 01 01 01 01 01 01 01 01 01 01 01 01 02 03 03 02 02 03 03 02 01
01 02 03 03 03 03 03 03 03 03 03 03 03 02 02 03 03 03 03 03 03 02 02 02 02 01 01 01 01 01 01 01 01 01 01 01 01 01 01 01 02 02 03 03 03 03 03 03 02 01
01 02 02 03 03 03 03 03 03 03 03 03 03 02 02 03 03 03 03 03 03 03 02 02 02 01 01 01 01 01 01 01 01 01 01 01 01 01 01 01 02 03 03 03 03 03 03 02 02 01
01 02 02 02 02 03 03 03 03 03 03 03 03 02 02 02 03 03 03 03 03 03 03 02 02 02 01 01 01 01 01 01 01 01 01 01 01 01 01 02 02 03 03 03 03 03 03 02 01 01
01 01 02 02 02 02 02 02 02 02 02 02 02 02 02 02 03 03 03 03 03 03 03 03 03 02 01 01 01 01 01 01 01 01 01 01 01 01 02 02 03 03 03 03 03 02 02 02 01 01
01 01 02 02 02 02 02 02 02 02 02 02 02 02 02 02 02 02 02 03 03 03 03 03 03 02 02 01 01 01 01 01 01 01 01 01 01 02 02 03 03 03 03 03 02 02 01 01 01 01
01 01 02 02 02 02 02 02 02 02 02 02 02 02 02 02 02 02 02 02 03 03 03 03 03 03 02 02 01 01 01 01 01 01 01 01 02 02 03 03 03 03 03 02 02 01 01 01 01 01
01 01 01 02 02 02 02 02 02 02 02 02 02 02 02 02 02 02 02 02 02 02 02 02 02 02 02 02 02 01 01 01 01 01 01 02 02 03 03 03 03 02 02 02 01 01 01 01 01 01
01 01 01 01 01 02 02 02 02 02 02 02 02 02 02 02 02 02 02 02 02 02 02 02 02 02 02 02 02 01 01 01 01 01 01 02 02 02 02 02 02 02 01 01 01 01 01 01 01 01
01 01 01 01 01 01 01 01 02 02 01 01 01 01 01 01 02 02 02 02 02 02 02 02 02 02 02 02 02 01 01 01 01 01 01 01 01 01 01 01 01 01 01 01 01 01 01 01 01 01
01 01 01 01 01 01 01 01 01 01 01 01 01 01 01 01 01 01 01 01 02 02 02 02 02 02 02 01 01 01 01 01 01 01 01 01 01 01 01 01 01 01 01 01 01 01 01 01 01 01
